NO ./texture/wall.jpeg
SO ./texture/wall.jpeg
WE ./texture/wall.jpeg
EA ./texture/wall.jpeg
F 220,100,00000
C 225,30,0




11111111111
101100111
10010N0001
111111111




