NO ./texture/1.png
SO ./texture/2.png
WE ./texture/3.png
D ./texture/5.png
EA ./texture/4.png
F 135,206,235
C 170,150,100

        111111111111111111111111111
        100000000011000000000000111
        101100000111000000000000111
        100100000000000000000000111
11111111101100000111000000000000111
1S000000001100000111011110001111111
111101111111110111000000100011111111111
11110111111111011101010010001111111
11000000110101011100101010001111111
10001000000000001100010010001111111
10000000000000001101010010001111111
11000001110101011111011110001111111
11110111 1110101 101111010001111111
11111111 1111111 111111111111111111
