NO ./texture/ wall q copy.jpeg
SO ./texture/ wall.jpeg
WE ./texture/wall copy.jpeg
EA ./texture/wallcopy.jpeg
C 225,30,0
F 220,100,00000




        111111111111111111111111111
        100000000011000000000000111
        101100000111000000000000111
        100100000000000000000000111
11111111101100000111000000000000111
10000000001100000111011110001111111
11110111111111011100000010001111111
11110111111111011101010010001111111
1100S000110101011100000010001111111
10000000000000001100000010001111111
10000000000000001101010010001111111
11000001110101011111011110001111111
11110111 1110101 101111010001111111
11111111 1111111 111111111111111111

