NO ./texture/wall.jpeg
SO ./texture/wall.jpeg
WE ./texture/wall.jpeg
EA ./texture/wall.jpeg
F 220,100,00000
C 225,30,0




111111
101001
100001
11N111
100011
101111
111111

